8 7
+ + +-+-+-+-+-+-+
|   | |   |     |
+ + + + + + +-+ +
| | |   | | | | |
+ + + +-+ + + + +
|   | |   | |   |
+-+ + + +-+ +-+-+
|   |   |     | |
+ + +-+ + +-+ + +
|       |       |
+-+-+-+ +-+ +-+-+
|   |     | |   |
+ + + +-+ + + +-+
|     |         |
+-+-+-+-+-+-+-+-+