5 3
+-+-+-+-+-+
|         |
+-+ +-+ + +
|     | | |
+ +-+-+ + +
| |     |
+-+ +-+-+-+